Albanian = Çfarë po bën?
Amharic = እርስዎ ምን እየሰሩ ነው?
Armenian = Ի՞նչ ես անում?
Azerbaijani = Nə edirsən?
Basque = Zer ari zara egiten?
Bosnian = Šta radiš?
Bulgarian = Какво правиш?
Burmese = နင် ဘာလုပ်နေလဲ?
Catalan = Què estàs fent?
Chinese (Simplified) = 你在做什么？
Chinese (Traditional) = 你在做什麼？
Croatian = Što radiš?
Czech = Co děláš?
Danish = Hvad laver du?
Dutch = Wat ben je aan het doen?
English = What are you doing?
Estonian = Mida sa teed?
Fijian = Na cava o cakava?
Finnish = Mitä sinä teet?
French = Que fais-tu?
Georgian = რას აკეთებ?
German = Was machst du?
Greek = Τι κάνεις?
Gujarati = તમે શું કરી રહ્યા છો?
Hausa = Me kake yi?
Hebrew = מה אתה עושה?
Hindi = तुम क्या कर रहे हो?
Hungarian = Mit csinálsz?
Icelandic = Hvað ertu að gera?
Indonesian = Apa yang kamu lakukan?
Irish = Cad atá á dhéanamh agat?
Italian = Cosa stai facendo?
Japanese = 何をしているの？
Javanese = Kowe lagi ngopo?
Kannada = ನೀನು ಏನು ಮಾಡುತ್ತಿದ್ದೀಯ?
Kazakh = Не істеп жатырсың?
Khmer = អ្នកកំពុងធ្វើអ្វី?
Korean = 뭐 하고 있어?
Kurdish = Çi dikî?
Lao = ເຈົ້າກຳລັງເຮັດຫຍັງ?
Latvian = Ko tu dari?
Lithuanian = Ką tu darai?
Macedonian = Што правиш?
Malay = Apa yang awak buat?
Maltese = X'qed tagħmel?
Marathi = तू काय करतो आहेस?
Mongolian = Чи юу хийж байна?
Nepali = तिमी के गर्दै छौ?
Norwegian = Hva gjør du?
Pashto = ته څه کوې؟
Persian (Farsi) = تو داری چکار می‌کنی؟
Polish = Co robisz?
Portuguese = O que você está fazendo?
Punjabi = ਤੁਸੀਂ ਕੀ ਕਰ ਰਹੇ ਹੋ?
Quechua = Imata ruwanki?
Romanian = Ce faci?
Russian = Что ты делаешь?
Samoan = O le ā le mea o fai?
Serbian = Шта радиш?
Sinhala = ඔයා මොකද කරන්නේ?
Slovak = Čo robíš?
Slovenian = Kaj delaš?
Somali = Maxaad sameyneysaa?
Swahili = Unafanya nini?
Swedish = Vad gör du?
Tagalog = Ano ang ginagawa mo?
Tajik = Шумо чӣ кор карда истодаед?
Tamil = நீ என்ன செய்கிறாய்?
Telugu = మీరు ఏమి చేస్తున్నారు?
Thai = คุณกำลังทำอะไร?
